Oppenheimer	The story of American scientist, J. Robert Oppenheimer, and his role in the development of the atomic bomb.
Dolittle	A physician who can talk to animals embarks on an adventure to find a legendary island with a young apprentice and a crew of strange pets.
Avengers: Endgame	After the devastating events of Avengers: Infinity War (2018), the universe is in ruins. With the help of remaining allies, the Avengers assemble once more in order to reverse Thanos' actions and restore balance to the universe.
Avengers: Infinity War	The Avengers and their allies must be willing to sacrifice all in an attempt to defeat the powerful Thanos before his blitz of devastation and ruin puts an end to the universe.
Spider-Man: Homecoming	Peter Parker balances his life as an ordinary high school student in Queens with his superhero alter-ego Spider-Man, and finds himself on the trail of a new menace prowling the skies of New York City.
Captain America: Civil War	Political involvement in the Avengers' affairs causes a rift between Captain America and Iron Man.
Avengers: Age of Ultron	When Tony Stark and Bruce Banner try to jump-start a dormant peacekeeping program called Ultron, things go horribly wrong and it's up to Earth's mightiest heroes to stop the villainous Ultron from enacting his terrible plan.
The Judge	Big-city lawyer Hank Palmer returns to his childhood home where his father, the town's judge, is suspected of murder. Hank sets out to discover the truth; along the way he reconnects with his estranged family.
Chef	A head chef quits his restaurant job and buys a food truck in an effort to reclaim his creative promise, while piecing back together his estranged family.
Iron Man 3	When Tony Stark's world is torn apart by a formidable terrorist called the Mandarin, he starts an odyssey of rebuilding and retribution.
The Avengers	Earth's mightiest heroes must come together and learn to fight as a team if they are going to stop the mischievous Loki and his alien army from enslaving humanity.
Sherlock Holmes: A Game of Shadows	Detective Sherlock Holmes is on the trail of criminal mastermind Professor Moriarty, who is carrying out a string of random crimes across Europe.
Due Date	High-strung father-to-be Peter Highman is forced to hitch a ride with aspiring actor Ethan Tremblay on a road trip in order to make it to his child's birth on time.
Iron Man 2	With the world now aware of his identity as Iron Man, Tony Stark must contend with both his declining health and a vengeful mad man with ties to his father's legacy.
Sherlock Holmes	Detective Sherlock Holmes and his stalwart partner Watson engage in a battle of wits and brawn with a nemesis whose plot is a threat to all of England.
The Soloist	A newspaper journalist discovers a homeless musical genius and tries to improve his situation.
Tropic Thunder	Through a series of freak occurrences, a group of actors shooting a big-budget war movie are forced to become the soldiers they are portraying.
The Incredible Hulk	Bruce Banner, a scientist on the run from the U.S. Government, must find a cure for the monster he turns into whenever he loses his temper.
Iron Man	After being held captive in an Afghan cave, billionaire engineer Tony Stark creates a unique weaponized suit of armor to fight evil.
Charlie Bartlett	A rich kid becomes the self-appointed psychiatrist to the student body of his new high school.
Lucky You	A hotshot poker player tries to win a tournament in Vegas, but is fighting a losing battle with his personal problems.
Zodiac	Between 1968 and 1983, a San Francisco cartoonist becomes an amateur detective obsessed with tracking down the Zodiac Killer, an unidentified individual who terrorizes Northern California with a killing spree.
Fur: An Imaginary Portrait of Diane Arbus	Turning her back on her wealthy, established family, Diane Arbus falls in love with Lionel Sweeney, an enigmatic mentor who introduces Arbus to the marginalized people who help her become one of the most revered photographers of the twentieth century.
A Scanner Darkly	An undercover cop in a not-too-distant future becomes involved with a dangerous new drug and begins to lose his own identity as a result.
The Shaggy Dog	A man tries to live a normal life despite the fact that he sometimes turns into a sheepdog.
A Guide to Recognizing Your Saints	Coming-of-age drama about a boy growing up in Astoria, New York during the 1980s. As his friends end up dead, on drugs or in prison, he comes to believe he has been saved from their fates by various so-called saints.
Good Night, and Good Luck.	Broadcast journalist Edward R. Murrow looks to bring down Senator Joseph McCarthy.
Kiss Kiss Bang Bang	After being mistaken for an actor, a New York thief is sent to Hollywood to train under a private eye for a potential movie role, but the duo are thrown together with a struggling actress into a murder mystery.
Game 6	Combining real and fictional events, this movie centers around the historic 1986 World Series, and a day in the life of a playwright who skips opening night to watch the momentous game.
Eros	Three short films, one each from Directors Michelangelo Antonioni, Steven Soderbergh, and Wong Kar Wai, address the themes of love and sex.
Gothika	A depressed psychiatrist wakes up as a patient in the asylum where she worked, with no memory of why she is there or what she has done.
The Singing Detective	From his hospital bed, a writer suffering from a skin disease hallucinates musical numbers and paranoid plots.
Wonder Boys	An English Professor tries to deal with his wife leaving him, the arrival of his editor who has been waiting for his book for seven years, and the various problems that his friends and associates involve him in.
Bowfinger	When a desperate movie producer fails to get a major star for his bargain-basement film, he decides to shoot the film secretly around him.
Friends & Lovers	Featuring an all-star cast including Academy Award nominee Robert Downey Jr., Stephen Baldwin, and super model Claudia Schiffer, FRIENDS & LOVERS is a sexy comedy about best friends who pair up in unexpected ways over a memorable weekend.
In Dreams	A suburban housewife learns that she has a dreamworld connection to a serial murderer, and must stop him from killing again.
U.S. Marshals	U.S. Marshal Samuel Gerard and his team of Marshals are assigned to track down Sheridan, who has been accused of a double-murder.
The Gingerbread Man	A lawyer uses his power to help his lover put her father behind bars, but when he escapes, they are all in danger.
Hugo Pool	An LA pool cleaner/Alyssa Milano falls in love with a young man with ALS/Lou Gehrig's Disease.
Two Girls and a Guy	Two girls wait outside a young actor's door and find out he's had them both as "only" girlfriend the last ten months. They wait inside after breaking in. When Blake comes home he just can't stop lying but they stay.
One Night Stand	Max/W.Snipes has a one night stand with Karen/N.Kinski in NYC. He returns to his wife, 2 kids and career in LA but is affected. A year later, Max and Karen meet again by chance, but this time they're with their spouses.
Danger Zone	American mining engineer gets involved in civil war and international conspiracy in an African country.
Restoration	The exiled royal physician to King Charles II devotes himself to helping Londoners suffering from the plague, and in the process falls in love with an equally poor woman.
Home for the Holidays	After losing her job, making out with her soon-to-be former boss, and finding out that her daughter plans to spend Thanksgiving with her boyfriend, Claudia Larson faces spending the holiday with her family.
Richard III	The classic Shakespearean play about the murderously scheming 15th-century king is reimagined in an alternative setting of 1930s England as clouds of fascism gather.
Only You	As a teen, Faith was told that her destiny is a man named Damon Bradley. Years later - Faith is about to marry another man - a Damon Bradley calls to wish them all the best. Faith blows off the wedding and follows Damon to Italy.
Natural Born Killers	Two victims of traumatized childhoods become lovers and psychopathic serial murderers irresponsibly glorified by the mass media.
Hail Caesar	Caesar is a would-be rock star. But for now, he works at a pencil eraser factory. Soon he falls in love with the owner's daughter. In order to get her, he bets with the old man that he can make a hundred thousand dollars in six months.â€”Steve Richer <sricher@sympatico.ca>
Heart and Souls	An unhappy businessman finds a new sense of purpose after he's tasked with helping a quartet of ghosts fulfill their last wishes before moving on to the afterlife.
Chaplin	An elderly Charlie Chaplin discusses his autobiography with his editor, recounting his amazing journey from his poverty-stricken childhood to world-wide success after the ingenious invention of the Little Tramp.
Soapdish	An ambitious television soap actress connives with her producer to scuttle the career of the show's long-time star, but nothing works as they plan.
Too Much Sun	A multimillionaire, whose son and daughter are gay, leaves a will with one clause: His children will inherit his money only if at least one of them produces him a grandchild within a year of his death.
Air America	A young pilot finds himself recruited unwittingly into a covert and corrupt CIA airlift operation in Laos during the Vietnam conflict.
Chances Are	A reincarnated man unknowingly falls in love with his own daughter from his previous life. Once he realizes this, he tries to end their relationship before angels erase his memory.
True Believer	A cynical former civil liberties attorney now reduced to "specializing" in defending drug dealers becomes transformed by an eight-year-old murder case.
That's Adequate	Fake documentary about a fictional Hollywood film studio.
1969	Two friends living in a small town during the 1960s, run away to enjoy their freedom during the Vietnam War, thus disappointing the father of one of them. When they return to town, they realize the importance of family unity.
Johnny Be Good	Johnny's the top high-school football player and many colleges want him. His girlfriend, coach and best friend want him in the college, serving themselves most.
Less Than Zero	A college freshman returns to L.A. for the holidays at his ex-girlfriend's request, but discovers that his former best friend has an out-of-control drug habit.
Rented Lips	A documentary filmmaker, who has spent the last 15 years making films like "Aluminum: Our Shiny Friend," is finally given the chance to make the documentary on Indian farming he has always wanted to. The catch? He must simultaneously direct a porn film. But as he tries to make the porn film, which he turns into a musical called "Halloween in the Barracks," he must deal with a temperamental actor, a fundamentalist preacher, and other obstacles.â€”Mike Myers <mmyers@ucsd.edu>
The Pick-up Artist	A womanizer meets his match when he falls for a woman in debt to the mafia.
America	The zany crew of a New York cable television station accidentally bounce a signal off the moon, bringing them worldwide attention.
Back to School	To help his discouraged son get through college, a funloving and obnoxious rich businessman decides to enter the school as a student himself.
Mussolini: The Untold Story	The rise and fall of the Italian fascist dictator, Benito Mussolini.
Weird Science	Two high-school nerds use a computer program to literally create the perfect woman, who promptly turns their lives upside-down.
Girls Just Want to Have Fun	Janey is new in town and soon meets Lynne, who shares her passion for dancing in general and "Dance TV" in particular.
Tuff Turf	The new kid in school must battle a gang of street toughs after stealing the gang leader's girl.
Firstborn	A teenager must protect his family when his mother's sinister new boyfriend begins exerting his authority in their home.
Baby It's You	In a 1966 New Jersey high school, Jill and new student Sheik from the other side of the tracks make their way in a first love romance.
Up the Academy	Four boys are sent, for different reasons, to a Military Academy. The life of discipline asks a lot of the four geeks. Of course these boys know how to make a party out of the hard times. Will they be "real men" after one year.
Greaser's Palace	A strange man named Jesse who can revive life and walk on water comes into a surreal and cruel western town.
Pound	In a pound, 18 dogs wait to be adopted.
