Extraction II	After barely surviving his grievous wounds from his mission in Dhaka, Bangladesh, Tyler Rake is back, and his team is ready to take on their next mission.
Thor: Love and Thunder	Thor enlists the help of Valkyrie, Korg and ex-girlfriend Jane Foster to fight Gorr the God Butcher, who intends to make the gods extinct.
Spiderhead	In the near future, convicts are offered the chance to volunteer as medical subjects to shorten their sentence. One such subject for a new drug capable of generating feelings of love begins questioning the reality of his emotions.
Interceptor	One Army captain must use her years of tactical training and military expertise when a simultaneous coordinated attack threatens the remote missile interceptor station she is in command of.
True Story	A tour stop in Kid's hometown of Philadelphia becomes a matter of life and death for one of the world's most famous comedians.
James and the Giant Peach with Taika and Friends	Actor and filmmaker Taika Waititi and a large cast of celebrities read Roald Dahl's James and the Giant Peach for charity.
Extraction	Tyler Rake, a fearless black market mercenary, embarks on the most deadly extraction of his career when he's enlisted to rescue the kidnapped son of an imprisoned international crime lord.
Jay and Silent Bob Reboot	Jay and Silent Bob inadvertently sign away their names and rights to the new Bluntman and Chronic movie. Now they head to Hollywood to stop the film from being made. Along the way Jay discovers that he is a father.
Men in Black: International	The Men in Black have always protected the Earth from the scum of the universe. In this new adventure, they tackle their biggest threat to date: a mole in the Men in Black organization.
Avengers: Endgame	After the devastating events of Avengers: Infinity War (2018), the universe is in ruins. With the help of remaining allies, the Avengers assemble once more in order to reverse Thanos' actions and restore balance to the universe.
Bad Times at the El Royale	1969. Four strangers check in at the El Royale Hotel. The hotel is deserted, staffed by a single desk clerk. Some of the new guests' reasons for being there are less than innocent and some are not who they appear to be.
Avengers: Infinity War	The Avengers and their allies must be willing to sacrifice all in an attempt to defeat the powerful Thanos before his blitz of devastation and ruin puts an end to the universe.
12 Strong	12 Strong tells the story of the first Special Forces team deployed to Afghanistan after 9/11; under the leadership of a new captain, the team must work with an Afghan warlord to take down the Taliban.
Thor: Ragnarok	Imprisoned on the planet Sakaar, Thor must race against time to return to Asgard and stop Ragnar√∂k, the destruction of his world, at the hands of the powerful and ruthless villain Hela.
Doctor Strange	While on a journey of physical and spiritual healing, a brilliant neurosurgeon is drawn into the world of the mystic arts.
Ghostbusters	Following a ghost invasion of Manhattan, paranormal enthusiasts Erin Gilbert and Abby Yates, nuclear engineer Jillian Holtzmann, and subway worker Patty Tolan band together to stop the otherworldly threat.
The Huntsman: Winter's War	Eric and fellow warrior Sara, raised as members of ice Queen Freya's army, try to conceal their forbidden love as they fight to survive the wicked intentions of both Freya and her sister Ravenna.
In the Heart of the Sea	A recounting of a New England whaling ship's sinking by a giant whale in 1820, an experience that later inspired the great novel Moby-Dick.
Avengers: Age of Ultron	When Tony Stark and Bruce Banner try to jump-start a dormant peacekeeping program called Ultron, things go horribly wrong and it's up to Earth's mightiest heroes to stop the villainous Ultron from enacting his terrible plan.
Blackhat	A furloughed convict and his American and Chinese partners hunt a high-level cybercrime network from Chicago to Los Angeles to Hong Kong to Jakarta.
Thor: The Dark World	When the Dark Elves attempt to plunge the universe into darkness, Thor must embark on a perilous and personal journey that will reunite him with doctor Jane Foster.
Red Dawn	A group of teenagers look to save their town from an invasion of North Korean soldiers.
Snow White and the Huntsman	In a twist to the fairy tale, the Huntsman ordered to take Snow White into the woods to be killed winds up becoming her protector and mentor in a quest to vanquish the Evil Queen.
The Avengers	Earth's mightiest heroes must come together and learn to fight as a team if they are going to stop the mischievous Loki and his alien army from enslaving humanity.
The Cabin in the Woods	Five friends go for a break at a remote cabin, where they get more than they bargained for, discovering the truth behind the cabin in the woods.
Thor	The powerful but arrogant god Thor is cast out of Asgard to live amongst humans in Midgard (Earth), where he soon becomes one of their finest defenders.
Ca$h	After a down-and-out couple finds a briefcase of money that solves all their problems, a menacing stranger forces them to commit a series of armed robberies to pay it all back.
A Perfect Getaway	Two pairs of lovers on a Hawaiian vacation discover that psychopaths are stalking and murdering tourists on the islands.
Star Trek	The brash James T. Kirk tries to live up to his father's legacy with Mr. Spock keeping him in check as a vengeful Romulan from the future creates black holes to destroy the Federation one planet at a time.
Marshall Law	Set against the backdrop of Melbourne Magistrates' Court, the series stars Lisa McCune and Alison Whye as two young lawyers, the Marshall sisters.
