Maestro	The complex love of Leonard and Felicia, from the time they met in 1946 at a party and continuing through two engagements, a 25-year marriage, and three children.
Guardians of the Galaxy Vol. 3	Still reeling from the loss of Gamora, Peter Quill rallies his team to defend the universe and one of their own - a mission that could mean the end of the Guardians if not successful.
Dungeons & Dragons: Honor Among Thieves	A charming thief and a band of unlikely adventurers embark on an epic quest to retrieve a lost relic, but things go dangerously awry when they run afoul of the wrong people.
Thor: Love and Thunder	Thor enlists the help of Valkyrie, Korg and ex-girlfriend Jane Foster to fight Gorr the God Butcher, who intends to make the gods extinct.
Nightmare Alley	A grifter working his way up from low-ranking carnival worker to lauded psychic medium matches wits with a psychologist bent on exposing him.
Licorice Pizza	The story of Alana Kane and Gary Valentine growing up, running around and going through the treacherous navigation of first love in the San Fernando Valley, 1973.
Avengers: Endgame	After the devastating events of Avengers: Infinity War (2018), the universe is in ruins. With the help of remaining allies, the Avengers assemble once more in order to reverse Thanos' actions and restore balance to the universe.
The Mule	A ninety-year-old horticulturist and Korean War veteran turns drug mule for a Mexican cartel.
A Star Is Born	A musician helps a young singer find fame as age and alcoholism send his own career into a downward spiral.
Avengers: Infinity War	The Avengers and their allies must be willing to sacrifice all in an attempt to defeat the powerful Thanos before his blitz of devastation and ruin puts an end to the universe.
Guardians of the Galaxy Vol. 2	The Guardians struggle to keep together as a team while dealing with their personal family issues, notably Star-Lord's encounter with his father, the ambitious celestial being Ego.
War Dogs	Loosely based on the true story of two young men, David Packouz and Efraim Diveroli, who won a three hundred million dollar contract from the Pentagon to arm America's allies in Afghanistan.
10 Cloverfield Lane	A young woman is held in an underground bunker by a man who insists that a hostile event has left the surface of the Earth uninhabitable.
Baby, Baby, Baby	The relationship between two mismatched people who try to move past their baggage to make their love work.
Wet Hot American Summer: First Day of Camp	Follows the counselors and campers on their first day at Camp Firewood in the summer of 1981.
American Sniper	Navy S.E.A.L. sniper Chris Kyle's pinpoint accuracy saves countless lives on the battlefield and turns him into a legend. Back home with his family after four tours of duty, however, Chris finds that it is the war he can't leave behind.
Guardians of the Galaxy	A group of intergalactic criminals must pull together to stop a fanatical warrior with plans to purge the universe.
American Hustle	A con man, Irving Rosenfeld, along with his seductive partner Sydney Prosser, is forced to work for a wild F.B.I. Agent, Richie DiMaso, who pushes them into a world of Jersey powerbrokers and the Mafia.
The Hangover Part III	When one of their own is kidnapped by an angry gangster, the Wolf Pack must track down Mr. Chow, who has escaped from prison and is on the run.
Silver Linings Playbook	After a stint in a mental institution, former teacher Pat Solitano moves back in with his parents and tries to reconcile with his ex-wife. Things get more challenging when Pat meets Tiffany, a mysterious girl with problems of her own.
The Place Beyond the Pines	A motorcycle stunt rider turns to robbing banks as a way to provide for his ex and their newborn, a decision that sets him on a collision course with an ambitious rookie cop navigating a department ruled by a corrupt detective.
The Words	A writer at the peak of his literary success discovers the steep price he must pay for stealing another man's work.
The Hangover Part II	Two years after the bachelor party in Las Vegas, Phil, Stu, Alan, and Doug jet to Thailand for Stu's wedding. Stu's plan for a subdued pre-wedding brunch, however, goes seriously awry.
The A-Team	A group of Iraq War veterans look to clear their name with the U.S. Military, who suspect the four men of committing a crime for which they were framed.
All About Steve	Convinced that a CCN cameraman is her true love, an eccentric crossword puzzler trails him as he travels all over the country, hoping to convince him that they belong together.
Case 39	A social worker fights to save a girl from her abusive parents, only to discover that the situation is more dangerous than she ever expected.
The Hangover	Three buddies wake up from a bachelor party in Las Vegas, with no memory of the previous night and the bachelor missing. They make their way around the city in order to find their friend before his wedding.
He's Just Not That Into You	This Baltimore-set movie of interconnecting story arcs deals with the challenges of reading or misreading human behavior.
Yes Man	A man challenges himself to say "yes" to everything.
New York, I Love You	Eleven love stories set in one of the most loved and hated cities of the world, New York City.
The Rocker	In the 1980s, a drummer is abandoned by his band just before they become rock superstars. Twenty years later, the drummer sees his second chance at stardom arise when he is asked to perform with his teenage nephew's high school rock band.
The Midnight Meat Train	A photographer's obsessive pursuit of dark subject matter leads him into the path of a serial killer who stalks late night commuters, ultimately butchering them in the most gruesome ways.
Older Than America	A Native American woman is haunted by visions that compel her to seek the truth about a residential school.
The Comebacks	A comedy that spoofs inspirational sports movies, this movie is about an out-of-luck coach who drives a rag-tag bunch of college misfits towards the football championship.
Failure to Launch	A thirty-something is still living with his parents until they hire an interventionist to help him graduate out of the house. That's when the fun begins.
Wedding Crashers	John Beckwith and Jeremy Grey, a pair of committed womanizers who sneak into weddings to take advantage of the romantic tinge in the air, find themselves at odds with one another when John meets and falls for Claire Cleary.
Bending All the Rules	An ambitious woman with an odd upbringing struggles to find herself amidst juggling two guys she's dating. Even though both guys know about each other and are complete opposites, jealousy begins to boil over as convivial antics break out between the two. Tough decisions will be made when growing up the hard way.â€”Elizabeth Obermeier, Marketing Manager
My Little Eye	Five people are offered one million dollars to spend six months together in an isolated mansion, with cameras watching their every move.
Wet Hot American Summer	Set on the last day of camp, in the hot summer of 1981, a group of counselors try to complete their unfinished business before the day ends.
